7 7 7 7 7 7 7 7 7 7 7 7 7 7 7 7 7 7 7 7 7 7 7 7 7 7 7 7 7 7
7 7 7 7 7 7 0 0 0 0 0 0 5 0 0 0 0 0 7 7 7 7 7 7 7 7 7 7 7 7
7 7 0 6 0 0 0 7 7 7 7 7 7 7 7 7 7 7 7 0 0 0 0 0 0 0 0 7 7 7
7 7 0 7 7 7 0 7 7 7 7 7 7 7 7 7 7 7 7 0 7 7 7 7 7 7 0 7 7 7
7 7 0 7 7 7 0 0 0 0 0 0 5 0 0 0 0 0 0 5 7 7 7 7 7 7 0 7 7 7
7 7 0 0 0 0 7 7 7 7 7 0 7 7 7 7 7 7 7 0 7 7 7 7 7 7 0 0 0 7
7 7 7 7 7 0 7 7 7 7 7 0 7 7 7 7 7 7 7 0 7 7 7 7 7 7 7 7 0 7
7 7 7 7 7 0 7 7 7 7 7 0 7 7 7 7 7 7 7 0 7 0 0 0 0 0 0 7 0 7
7 7 0 0 0 0 7 7 7 7 7 0 7 7 7 7 7 7 7 0 7 0 7 7 7 7 0 7 0 7
0 0 0 7 7 7 7 7 0 0 0 0 0 0 0 0 6 7 7 0 7 0 7 7 0 0 0 7 0 7
0 7 7 7 7 7 7 7 7 7 7 7 7 7 7 7 0 7 7 0 7 0 7 7 0 7 7 7 0 7
1 0 0 0 0 0 0 0 0 0 0 0 0 0 0 0 0 7 7 0 0 0 7 7 0 0 0 0 0 7
7 7 7 7 7 7 7 7 7 7 7 7 7 7 7 7 7 7 7 7 7 7 7 7 0 7 7 7 7 7
7 7 7 7 7 7 0 0 0 0 0 0 0 0 0 0 0 0 0 0 0 0 0 0 0 0 0 0 0 0
7 0 7 7 7 7 0 7 0 7 7 7 7 7 7 7 7 7 7 7 7 7 7 7 7 7 7 7 7 7
7 0 7 7 7 7 0 7 0 7 7 7 7 7 7 7 7 7 7 7 7 7 7 7 7 7 7 7 7 7
7 0 7 7 7 7 0 7 0 7 7 7 7 7 7 7 7 7 7 7 7 7 7 7 7 7 7 7 7 7
7 0 0 0 0 7 0 7 0 7 7 7 7 7 7 7 7 7 7 7 7 7 7 7 7 7 7 7 7 7
7 0 7 7 0 7 0 7 0 7 7 7 0 0 0 0 5 0 0 0 0 0 0 0 0 0 7 7 7 7
7 0 7 7 0 7 0 7 0 7 7 7 0 7 7 7 7 7 7 7 7 7 7 7 7 0 7 7 7 7
7 0 7 7 0 0 0 7 0 7 7 7 0 7 7 7 7 7 7 7 7 7 7 7 7 0 7 7 7 7
7 0 7 7 7 7 7 7 0 7 7 7 0 7 7 7 0 0 0 0 0 7 7 7 7 0 7 7 7 7
7 0 0 0 0 0 0 0 0 7 7 7 0 7 7 7 0 7 7 7 0 7 7 7 7 0 7 7 7 7
7 7 0 7 7 7 7 7 7 7 7 7 0 0 0 0 0 7 7 7 0 0 0 0 7 0 7 7 7 7
7 7 0 7 7 7 7 7 7 7 7 7 7 7 7 7 0 7 7 7 0 7 7 0 7 0 7 7 7 7
7 7 0 7 7 7 7 7 7 6 0 0 0 0 0 0 0 7 7 7 0 7 7 0 7 0 7 7 7 7
7 7 5 7 7 7 7 7 7 7 7 7 7 7 7 7 7 7 7 7 0 7 7 0 0 0 7 7 7 7
7 7 0 0 0 0 0 0 0 0 0 0 0 0 0 0 0 0 0 0 0 7 7 7 7 7 7 7 7 7
7 7 7 7 7 7 7 7 7 7 7 7 7 7 7 7 7 7 7 7 7 7 7 7 7 7 7 7 7 7
7 7 7 7 7 7 7 7 7 7 7 7 7 7 7 7 7 7 7 7 7 7 7 7 7 7 7 7 7 7
